###Japan###
JAP = "countries/Japan.txt"
###Korea###
KOR = "countries/Korea.txt"
###China####
SHA = "countries/Shanghai.txt"
TIB = "countries/Tibet.txt"
TAI = "countries/Taiwan.txt"
DAL = "countries/Dalian Revolutionary Front.txt"
WRC = "countries/Welfare Republic of China.txt"
FHT = "countries/Folk Hometown.txt"
SOL = "countries/State of Lu.txt"
NFM = "countries/New Federal Movement.txt"
CHG = "countries/State of Chuang.txt"
CMS = "countries/Commune of Spark.txt"
GUD = "countries/Guangdong.txt"
YUN = "countries/National Salvation Army.txt"
SWU = "countries/Southwestern Associated University.txt"
BFA = "countries/Black Flag Army.txt"
HOK = "countries/Hokkien Republic.txt"
CHQ = "countries/Chongqing.txt"
BAS = "countries/Basuria.txt"
BMR = "countries/Beijing Military Region.txt"
IDJ = "countries/Industrial District of Jiuquan.txt"
IDX = "countries/Industrial District of Xining.txt"
XIJ = "countries/Han Garrison.txt"
ETK = "countries/East Turkestan.txt"
HUB = "countries/Resistance Government.txt"
CST = "countries/Celestial State of Tao.txt"
CHC = "countries/Beijing Commune.txt"
WEI = "countries/Wei Empire.txt"
XMN = "countries/Xiamen.txt"
PGJ = "countries/Provisional Government of Jiangnan.txt"
MAN = "countries/Manchukuo.txt"
FSD = "countries/Falun State of Dharmapala.txt"
QIN = "countries/Qing.txt"
HNG = "countries/Hong Kong.txt"
###Great Steppe#
MON = "countries/Mongolia.txt"
KAZ = "countries/Kazakhstan.txt"
TAJ = "countries/Tajikistan.txt"
TMS = "countries/Turkmenistan.txt"
UZB = "countries/Uzbekistan.txt"
KYR = "countries/Kyrgyzstan.txt"
RNG = "countries/Russian National State.txt"
NZZ = "countries/Neutral Zhuz.txt"
RLF = "countries/Russian Liberation Front.txt"
SGD = "countries/Sogdia.txt"
CMD = "countries/Central Military District.txt"
###Anatolia###
TUR = "countries/Turkey.txt"
BYZ = "countries/Byzantian Turkey.txt"
###Scandinavia###
SCA = "countries/Scandinavia.txt"
FIN = "countries/Finland.txt"
SWE = "countries/Sweden.txt"
NOR = "countries/Norway.txt"
DEN = "countries/Denmark.txt"
ICE = "countries/Iceland.txt"
###Wenedia###
POL = "countries/Poland.txt"
NLF = "countries/Nilfgaard Poland.txt"
URL = "countries/Beasts Poland.txt"
LIT = "countries/Lithuania.txt"
EST = "countries/Estonia.txt"
BAL = "countries/Baltica.txt"
PLP = "countries/Kashubia.txt"
TRG = "countries/Torgu.txt"
PDE = "countries/Silesia.txt"
###Iran###
PER = "countries/Persia.txt"
AFG = "countries/Afghanistan.txt"
###Germany###
GER = "countries/Germany.txt"
GNR = "countries/German Nationalists.txt"
###France###
FRA = "countries/France.txt"
FCR = "countries/French Commune.txt"
###Africa###
DJI = "countries/Djibouti.txt"
CHD = "countries/Chad.txt"
CMR = "countries/Cameroon.txt"
NIG = "countries/Nigeria.txt"
ZZZ = "countries/HAARP.txt" 
CAR = "countries/Central African Republic.txt" 
SUD = "countries/Sudan.txt" 
SOM = "countries/Somalia.txt" 
ETH = "countries/Ethiopia.txt"
BIA = "countries/Biafra.txt" 
KAB = "countries/Kabylia.txt" 
ODU = "countries/Oduduwa.txt" 
AMB = "countries/Ambazonia.txt"  
ALG = "countries/Algeria.txt" 
MOR = "countries/Morocco.txt"
WSH = "countries/Western Sahara.txt" 
NGR = "countries/Niger.txt" 
MAU = "countries/Mauritania.txt" 
MAL = "countries/Mali.txt" 
GMB = "countries/Gambia.txt"
SNG = "countries/Senegal.txt" 
GBS = "countries/Guinea-Bissau.txt" 
GUI = "countries/Guinea.txt" 
SRL = "countries/Sierra Leone.txt"  
LIB = "countries/Liberia.txt" 
IVC = "countries/Ivory Coast.txt"
BKF = "countries/Burkina Faso.txt" 
BNN = "countries/Benin.txt" 
TOG = "countries/Togo.txt" 
GHA = "countries/Ghana.txt" 
###Central Europe###
HOL = "countries/Netherlands.txt"
SLO = "countries/Slovakia.txt"
CZE = "countries/Czehia.txt"
LUX = "countries/Luxembourg.txt"
SWI = "countries/Switzerland.txt"
BEL = "countries/Belgium.txt"
WAL = "countries/Wallonie.txt"
AUS = "countries/Austria.txt"
LIE = "countries/Liechtenstein.txt"
###North Russia###
NSU = "countries/Neo Soviet.txt"
NRU = "countries/Nordic Russia.txt"
LEN = "countries/Lenoblast.txt"
###South Russia###
RGD = "countries/Rosgvardia.txt"
COU = "countries/Couban.txt"
ACH = "countries/Cossacks.txt"
KAL = "countries/Kalmykia.txt" 
CHE = "countries/Chechnya.txt"
RST = "countries/Roman Social Tsardom.txt"
STR = "countries/Southern Regency.txt"
###Central Russia###
MSC = "countries/Moscow.txt"
RTS = "countries/Russian Tsardom.txt"
STM = "countries/Sterligov Manor.txt"
UST = "countries/Union state.txt"
TAT = "countries/Tatarstan.txt"
FRS = "countries/Free State.txt"
BSK = "countries/Bashkortostan.txt"
RNE = "countries/Russian nationalist republic.txt"
RWR = "countries/Russian worker republic.txt"
CHS = "countries/Chuvashia.txt"
###Cyberia###
GAZ = "countries/Gazprom.txt"
RZD = "countries/Russian Railways.txt"
SAH = "countries/Sakhalin.txt"
YAK = "countries/Yakutia.txt"
CPU = "countries/Conceptual Party Unity.txt"
GOR = "countries/Anarchy State.txt"
NOD = "countries/National Liberation Movement.txt"
KRS = "countries/Krasnoyarsk.txt"
IMT = "countries/Romanov Empire.txt"
NVS = "countries/Novosibirsk.txt"
TVA = "countries/Tuva.txt"
EKB = "countries/Cartel.txt"
GUL = "countries/Gulag.txt"
RIS = "countries/Russian Imperial State.txt"
###Yugoslavia###
SLV = "countries/Slovenia.txt"
YUG = "countries/Yugoslavia.txt"
BOS = "countries/Bosnia.txt"
CRO = "countries/Croatia.txt"
###Albion###
ESS = "countries/Essex.txt"
EAG = "countries/Freistaat Ostengland.txt"
KNT = "countries/Kent.txt"
MRC = "countries/Mercia.txt"
NTH = "countries/Northumbria.txt"
SUS = "countries/Sussex.txt"
WES = "countries/Wessex.txt"
SCO = "countries/Scotland.txt"
WLS = "countries/Wales.txt"
ULS = "countries/Ulster.txt"
IRE = "countries/Ireland.txt"
###Albion Collapse###
###Haemus###
GRE = "countries/Greece.txt"
ALB = "countries/Albania.txt"
BUL = "countries/Bulgaria.txt"
MAC = "countries/Macedonia.txt"
ATH = "countries/Athos.txt"
ROM = "countries/Romania.txt"
HUN = "countries/Hungary.txt"
ANR = "countries/Anarch Romania.txt"
SBT = "countries/Sabbat Romania.txt"
###Arabia###
BHR = "countries/Bahrain.txt" ###Actually Saudi Arabia
BAH = "countries/Real Bahrain.txt" ###Actually Saudi Arabia
HAR = "countries/Hashemite Arabia.txt"
OMA = "countries/Oman.txt"
YEM = "countries/Yemen.txt"
KUW = "countries/Kuwait.txt"
QAT = "countries/Qatar.txt"
EMI = "countries/Emirates.txt"
UAS = "countries/United Arab State.txt"
HOU = "countries/Houthis.txt"
###Iberia###
SPA = "countries/Spain.txt"
POR = "countries/Portugal.txt"
ALV = "countries/Algarve.txt"
AND = "countries/Andalusia.txt"
NAV = "countries/Navarra.txt"
CAT = "countries/Catalonia.txt"
ADR = "countries/Andorra.txt"
###South Asia###
IND = "countries/India.txt"
BLC = "countries/Balochistan.txt"
NPA = "countries/Northern Provisional Authority.txt"
PAK = "countries/Pakistan.txt"
PNJ = "countries/Punjab.txt"
SIN = "countries/Sindh.txt"
BNG = "countries/Bangladesh.txt"
BHU = "countries/Bhutan.txt"
NPL = "countries/Nepal.txt"
SRI = "countries/Sri Lanka.txt"
ALF = "countries/Asian Liberation Front.txt"
MNM = "countries/Myanmar.txt"
BMN = "countries/Buddhist Myanmar.txt"
LAO = "countries/Laos.txt"
VIE = "countries/Vietnam.txt"
THA = "countries/Thailand.txt"
PHI = "countries/Philippines.txt"
MLS = "countries/Malaysia.txt"
KHM = "countries/Khmer Republic.txt"
SGP = "countries/Singapore.txt"
###Malorossia###
GAL = "countries/Galitzia.txt"
UCS = "countries/Ukrainian Civic State.txt"
UPS = "countries/Ukrainian Peoples National State.txt"
UBR = "countries/Ukrainian Blessed Republic.txt"
UKS = "countries/Ukrainian State.txt"
GDR = "countries/Grand Duchy of Ruthenia.txt"
MLP = "countries/Malorosian Province.txt"
HRU = "countries/Holly Rus.txt"
RUK = "countries/RusUkraina.txt"
NUR = "countries/National Democratic Ukrainian Republic.txt"
KHA = "countries/Kharkiv.txt"
MLR = "countries/Malorossia.txt"
###Novorossija###
NRS = "countries/Novorossija.txt"
PSN = "countries/Peoples Soviet Republic of Novorossija.txt"
NRP = "countries/Novorossian Republic.txt"
PRE = "countries/Transnistria.txt"
SLU = "countries/Slavic Union.txt"
KRY = "countries/Krivoj Rog.txt"
###Trans-Caucasia###
AZE = "countries/Azerbaijan.txt"
KAR = "countries/Karabakh.txt"
GEO = "countries/Georgia.txt"
ARM = "countries/Armenia.txt"
###Apennine###
SRD = "countries/Sardinia.txt"
ITA = "countries/Italian Republic.txt"
SOC = "countries/Latium.txt"
LUM = "countries/L'Unione del Mezzogiorno.txt"
PAD = "countries/Padania.txt"
MLT = "countries/Malta.txt"
MNC = "countries/Monaco.txt"
SIC = "countries/Sicily.txt"
VNZ = "countries/Republic of Venezia.txt"
TYR = "countries/Tyrol.txt"
SAN = "countries/San Marino.txt"
TUS = "countries/Tuscany.txt"
###Sham###
ASS = "countries/Assad Syria.txt" ###Assad
LEB = "countries/Phoenicia.txt"
ISR = "countries/Israel.txt"
SYR = "countries/Syria.txt" ###Pro-Iraq forces 
TSY = "countries/Turkish Syria.txt" ###Atlantist Syria
IRQ = "countries/Iraq.txt"
SKD = "countries/Syrian Kurdistan.txt"
DRU = "countries/Druze.txt"
PAL = "countries/Palestine.txt"
###North Africa###
EGY = "countries/Egypt.txt" 
##SECRET##
CUM = "countries/Kamchatka.txt" 
